yotta	Y
zetta	Z
exa	E
péta	P
téra	T
giga	G
méga	M
kilo	k
hecto	h
déca	da
déci	d
centi	c
milli	m
micro	µ
nano	n
pico	p
femto	f
atto	a
zepto	z
yocto	y
décimilli	dm
myria	ma
