bitcoin	BTC
ethereum	ETH
xrp	XRP
litecoin	LTC
eos	EOS
bitcoin cash	BCH
binance coin	BNB
stellar	XLM
tether	USDT
tron	TRX
cardano	ADA
bitcoin sv	BSV
monero	XMR
iota	MIOTA
dash	DASH
maker	MKR
ontology	ONT
neo	NEO
ethereum classic	ETC
nem	XEM
tezos	XTZ
zcash	ZEC
vechain	VET
crypto.com chain	CRO
waves	WAVES
dogecoin	DOGE
usd coin	USDC
bitcoin gold	BTG
qtum	QTUM
omisego	OMG
trueusd	TUSD
decred	DCR
lisk	LSK
chainlink	LINK
zilliqa	ZIL
augur	REP
icon	ICX
holo	HOT
0x	ZRX
digibyte	DGB
steem	STEEM
enjin coin	ENJ
ravencoin	RVN
bytecoin	BCN
bittorrent	BTT
bitshares	BTS
nano	NANO
bitcoin diamond	BCD
huobi token	HT
theta	THETA
komodo	KMD
aeternity	AE
abbc coin	ABBC
verge	XVG
siacoin	SC
bytom	BTM
pundi x	NPXS
iost	IOST
kucoin shares	KCS
dai	DAI
stratis	STRAT
aurora	AOA
maximine coin	MXM
status	SNT
populous	PPT
golem	GNT
project pai	PAI
insight chain	INB
repo	REPO
ardor	ARDR
gxchain	GXC
revain	R
ark	ARK
gemini dollar	GUSD
cryptonex	CNX
mixin	XIN
factom	FCT
wax	WAX
hypercash	HC
maidsafecoin	MAID
electroneum	ETN
digitex futures	DGTX
loom network	LOOM
loopring	LRC
qash	QASH
crypto.com	MCO
waltonchain	WTC
decentraland	MANA
qubitica	QBIT
aelf	ELF
thorecoin	THR
pivx	PIVX
zcoin	XZC
nexo	NEXO
moac	MOAC
wanchain	WAN
kyber network	KNC
power ledger	POWR
elastos	ELA
horizen	ZEN
aion	AION
metaverse etp	ETP
nebulas	NAS
bancor	BNT
dent	DENT
odem	ODE
nuls	NULS
reddcoin	RDD
linkey	LKY
bibox token	BIX
storj	STORJ
polymath	POLY
stasis eurs	EURS
kin	KIN
monacoin	MONA
waykichain	WICC
digixdao	DGD
truechain	TRUE
quant	QNT
enigma	ENG
quarkchain	QKC
syscoin	SYS
veritaseum	VERI
cosmo coin	COSM
iexec rlc	RLC
tenx	PAY
groestlcoin	GRS
tomochain	TOMO
metadium	META
funfair	FUN
singularitynet	AGI
nxt	NXT
ormeus coin	ORME
tokenpay	TPAY
civic	CVC
latoken	LA
gas	GAS
cybermiles	CMT
obyte	GBYTE
davinci coin	DAC
nexus	NXS
prizm	PZM
mithril	MITH
cortex	CTXC
smartlands	SLT
vertcoin	VTC
#metahash	MHC
endor protocol	EDR
iotex	IOTX
mainframe	MFT
cindicator	CND
credo	CREDO
bread	BRD
dragonchain	DRGN
apollo currency	APL
eidoo	EDO
neblio	NEBL
gold bits coin	GBC
oneroot network	RNT
cube	AUTO
ecoreal estate	ECOREAL
gifto	GTO
tokenclub	TCT
s4fe	S4F
particl	PART
storm	STORM
energi	NRG
request	REQ
robotina	ROX
unobtanium	UNO
gochain	GO
bezant	BZNT
vestchain	VEST
ttc protocol	TTC
genesis vision	GVT
telcoin	TEL
ino coin	INO
next	NET
stem cell coin	SCC
sirin labs token	SRN
odyssey	OCN
moss coin	MOC
everipedia	IQ
crypto20	C20
clams	CLAM
cwv chain	CWV
bitcapitalvendor	BCV
smartmesh	SMT
po.et	POE
ethos	ETHOS
smartcash	SMART
ost	OST
skycoin	SKY
own	CHX
gnosis	GNO
bnktothefuture	BFT
einsteinium	EMC2
aragon	ANT
metal	MTL
proximax	XPX
credits	CS
tokencard	TKN
platincoin	PLC
ignis	IGNIS
wagerr	WGR
tael	WABI
xyo	XYO
noah coin	NOAH
fusion	FSN
medibloc erc20	MEDX
hycon	HYC
streamr datacoin	DATA
grin	GRIN
arcblock	ABT
edgeless	EDG
nkn	NKN
locktrip	LOC
ren	REN
crypterium	CRPT
pressone	PRS
quantstamp	QSP
emercoin	EMC
dentacoin	DCN
peercoin	PPC
ruff	RUFF
thekey	TKY
blocknet	BLOCK
dmarket	DMT
bitkan	KAN
navcoin	NAV
medishares	MDS
fantom	FTM
coinus	CNUS
utrust	UTK
melon	MLN
hyperion	HYN
bluzelle	BLZ
vibe	VIBE
mobilego	MGO
viacoin	VIA
solve	SOLVE
salt	SALT
stakenet	XSN
bitcoiin	B2G
pepe cash	PEPECASH
paragon	PRG
pumapay	PMA
dropil	DROP
namecoin	NMC
humanscape	HUM
blockv	VEE
apis	APIS
cybervein	CVT
scry.info	DDD
adex	ADX
lambda	LAMB
nucleus vision	NCASH
data	DTA
gulden	NLG
ethlend	LEND
boscoin	BOS
leocoin	LEO
presearch	PRE
iot chain	ITC
tokenomy	TEN
achain	ACT
singulardtv	SNGLS
primalbase token	PBT
ubiq	UBQ
insolar	INS
steem dollars	SBD
agrello	DLT
qlc chain	QLC
decentbet	DBET
medibloc qrc20	MED
bridgecoin	BCO
district0x	DNT
sonm	SNM
sdchain	SDA
mobius	MOBI
ambrosus	AMB
metronome	MET
btu protocol	BTU
time new bank	TNB
zipper	ZIP
selfkey	KEY
fortuna	FOTA
aston	ATX
propy	PRO
snapcoin	SNPC
burst	BURST
tierion	TNT
vite	VITE
coss	COSS
flo	FLO
evencoin	EVN
origintrail	TRAC
bittube	TUBE
pillar	PLR
breezecoin	BRZC
appcoins	APPC
aeron	ARN
all sports	SOC
refereum	RFR
loopring neo	LRN
substratum	SUB
digitalnote	XDN
online	OIO
cpchain	CPC
cred	LBA
zrcoin	ZRC
wepower	WPR
scrl	SCRL
boolberry	BBR
whitecoin	XWC
blackcoin	BLK
beam	BEAM
parkingo	GOT
electra	ECA
game.com	GTC
doc.com token	MTC
bitcny	BITCNY
asch	XAS
trade token x	TIOX
numeraire	NMR
bitbay	BAY
poa network	POA
gamecredits	GAME
bhpcash	BHPC
jibrel network	JNT
everex	EVX
cryptaur	CPT
nix	NIX
swarm	SWM
envion	EVN
foam	FOAM
zclassic	ZCL
etherparty	FUEL
seele	SEELE
universa	UTNP
spendcoin	SPND
e-dinar coin	EDR
free coin	FREE
dxchain token	DX
hydro	HYDRO
ternio	TERN
aergo	AERGO
nasdacoin	NSD
pchain	PAI
canonchain	CZR
bitcoin private	BTCP
salus	SLS
tripio	TRIO
dero	DERO
litecoin cash	LCC
daps token	DAPS
lgo exchange	LGO
paypie	PPP
lbry credits	LBC
rchain	RHOC
airswap	AST
pascal coin	PASC
blox	CDT
lunyr	LUN
monetha	MTH
blockport	BPT
yoyow	YOYOW
neumark	NEU
stableusd	USDS
cashaa	CAS
loyalcoin	LYL
primas	PST
vitae	VITAE
aurumcoin	AU
deepbrain chain	DBC
incent	INCNT
swissborg	CHSB
callisto network	CLO
mercury	MER
qchi	QCH
napoleonx	NPX
polybius	PLBT
ac3	AC3
xtrabytes	XBY
viberate	VIB
smartofgiving	AOG
beetle coin	BEET
playgroundz	IOG
lympo	LYM
genaro network	GNX
stacs	STACS
lto network	LTO
loki	LOKI
neurotoken	NTK
bitusd	BITUSD
polis	POLIS
baasid	BAAS
wowbit	WWB
kambria	KAT
smartshare	SSP
counterparty	XCP
dock	DOCK
bitcore	BTX
unikoin gold	UKG
penta	PNT
amoveo	VEO
cajutel	CAJ
bit-z token	BZ
babb	BAX
halalchain	HLC
shift	SHIFT
adtoken	ADT
cobinhood	COB
swftcoin	SWFTC
lina	LINA
everus	EVR
aurora dao	AURA
bottos	BTO
wings	WINGS
airbloc	ABL
casinocoin	CSC
digix gold token	DGX
playcoin erc20	PLY
omnitude	ECOM
linda	LINDA
mark.space	MRK
paccoin	$PAC
massgrid	MGD
rublix	RBLX
primecoin	XPM
deeponion	ONION
potcoin	POT
gincoin	GIN
morpheus.network	MRPH
i/o coin	IOC
te-food	TFD
dimcoin	DIM
bittwatt	BWT
eosdac	EOSDAC
oax	OAX
timicoin	TMC
quasarcoin	QAC
ulord	UT
six	SIX
bitcoin green	BITG
zeepin	ZPT
apex	CPX
spacechain	SPC
peerplays	PPY
blue whale token	BWX
htmlcoin	HTML
skrumble network	SKM
cashbery coin	CBC
travala.com	AVA
ebcoin	EBC
fiii	FIII
0chain	ZCN
stealth	XST
dex	DEX
graft	GRFT
spectrecoin	XSPEC
clipper coin	CCCX
crypticcoin	CRYP
colossusxt	COLX
remme	REM
feathercoin	FTC
b2bx	B2B
get protocol	GET
ink	INK
cloakcoin	CLOAK
box token	BOX
delphy	DPY
unibright	UBT
qunqun	QUN
xaurum	XAUR
pal network	PAL
crown	CRW
ice rock mining	ROCK2
experience chain	XPC
rotharium	RTH
polyswarm	NCT
lamden	TAU
carvertical	CV
vericoin	VRC
atc coin	ATCC
sense	SENSE
chatcoin	CHAT
flash	FLASH
everycoin	EVY
phore	PHR
nimiq	NIM
moneytoken	IMT
edrcoin	EDRC
hempcoin	THC
naga	NGC
dynamic	DYN
decent	DCT
uptoken	UP
educare	EKT
plair	PLA
daostack	GEN
bitguild plat	PLAT
gmb	GMB
nexty	NTY
zebi	ZCO
sakura bloom	SKB
nanjcoin	NANJ
spankchain	SPANK
divi	DIVI
turtlecoin	TRTL
change	CAG
kickcoin	KICK
dadi	DADI
weshow token	WET
xel	XEL
peculium	PCL
kcash	KCASH
linkeye	LET
commerceblock	CBT
sureremit	RMT
radium	RADS
contentbox	BOX
decision token	HST
rightmesh	RMESH
solarcoin	SLR
mib coin	MIB
bean cash	BITB
cloudbric	CLB
suncontract	SNC
monetaryunit	MUE
daex	DAX
atn	ATN
valuecybertoken	VCT
storiqa	STQ
sentinel	SENT
vipstar coin	VIPS
dacsee	DACS
plus-coin	NPLC
eden	EDN
vinchain	VIN
sophiatx	SPHTX
safeinsure	SINS
transfercoin	TX
revolutionvr	RVR
insureum	ISR
aidcoin	AID
dubaicoin	DBIX
blackmoon	BMC
noku	NOKU
spindle	SPD
bitcoin atom	BCA
winco	WCO
hydro protocol	HOT
vezt	VZT
ultiledger	ULT
fanstime	FTI
bitmart token	BMX
zen protocol	ZP
bitcoin interest	BCI
fuzex	FXT
axpire	AXPR
etheroll	DICE
fountain	FTN
cvcoin	CVN
nolimitcoin	NLC2
ion	ION
fintrux network	FTX
modum	MOD
playchip	PLA
adbank	ADB
semux	SEM
cardstack	CARD
farmatrust	FTT
mktcoin	MLM
consensus	SEN
xmax	XMX
lendingblock	LND
myriad	XMY
hashgard	GARD
zap	ZAP
mvl	MVL
gridcoin	GRC
cova	COVA
haven protocol	XHV
traxia	TMT
xinfin network	XDCE
ai doctor	AIDOC
suqa	SUQA
u network	UUU
switcheo	SWTH
oraclechain	OCT
localcoinswap	LCS
gonetwork	GOT
yee	YEE
litex	LXT
sharder	SS
yggdrash	YEED
gentarium	GTM
ceek vr	CEEK
soundac	XSD
winding tree	LIF
opacity	OPQ
zelcash	ZEL
hyperspace	AMP
egretia	EGT
espers	ESP
toacoin	TOA
starcoin	KST
sphere	SPHR
rate3	RTE
humaniq	HMQ
the abyss	ABYSS
pluton	PLU
exrnchain	EXRN
universal cash	UCASH
karma	KARMA
incodium	INCO
zper	ZPR
vexanium	VEX
phantasma	SOUL
snetwork	SNET
morpheus labs	MITX
paypex	PAYX
omni	OMNI
friendz	FDZ
bloom	BLT
halo platform	HALO
medicalchain	MTN
robet	ROBET
neurochain	NCC
footballcoin	XFC
goldcoin	GLC
alphaslot	SLOT
luxcoin	LUX
cargox	CXO
covesting	COV
welltrado	WTL
skychain	SKCH
zeusshield	ZSC
happycoin	HPC
effect.ai	EFX
fnkos	FNKOS
wibson	WIB
darcrus	DAR
matchpool	GUP
geocoin	GEO
constellation	DAG
oxycoin	OXY
selfsell	SSC
horuspay	HORUS
bezop	BEZ
wixlar	WIX
midasprotocol	MAS
brickblock	BBK
aventus	AVT
copytrack	CPY
curecoin	CURE
vegawallet token	VGW
kore	KORE
bankex	BKX
cappasity	CAPP
scorum coins	SCR
kryll	KRL
kuai token	KT
banca	BANCA
bitcrystals	BCY
popchain	PCH
echolink	EKO
ink protocol	XNK
fluz fluz	FLUZ
life	LIFE
prochain	PRA
dignity	DIG
ubex	UBEX
chronobank	TIME
hoqu	HQX
alis	ALIS
stellite	XTL
serve	SERV
bulwark	BWK
olympus labs	MOT
upfiring	UFR
anoncoin	ANC
avinoc	AVINOC
latiumx	LATX
atlant	ATL
tolar	TOL
pirl	PIRL
minexcoin	MNX
rise	RISE
nebula ai	NBAI
kleros	PNK
globatalent	GBT
paycent	PYN
stk	STK
ugchain	UGC
mybit	MYB
howdoo	UDOO
qbao	QBT
internxt	INXT
rivetz	RVT
giant	GIC
datum	DAT
okcash	OK
pedity	PEDI
deviantcoin	DEV
hashcoin	HSC
srcoin	SRCOIN
flixxo	FLIXX
rapids	RPD
zmine	ZMN
sibcoin	SIB
bitsend	BSD
trueflip	TFL
capricoin	CPC
patientory	PTOY
repme	RPM
dovu	DOV
bodhi	BOT
pikciochain	PKC
dnotes	NOTE
snowgem	XSG
privatix	PRIX
expanse	EXP
ifoods chain	IFOOD
eroscoin	ERO
indahash	IDH
birake	BIR
on.live	ONL
maincoin	MNC
datx	DATX
electrify.asia	ELEC
mtc mesh network	MTC
nework	NKC
ergo	EFYT
eligma token	ELI
domraider	DRT
olive	OLE
musicoin	MUSIC
gems	GEM
vouchforme	IPL
bitcoinz	BTCZ
essentia	ESS
masari	MSR
cashbet coin	CBC
blue protocol	BLUE
scanetchain	SWC
coinpoker	CHP
pundi x nem	NPXSXEM
silent notary	SNTR
hollywoodcoin	HWC
red	RED
stakinglab	LABX
swarm city	SWT
insights network	INSTAR
novacoin	NVC
ondori	RSTR
lethean	LTHN
artbyte	ABY
oneledger	OLT
x-cash	XCASH
dav coin	DAV
banyan network	BBN
data exchange	DTX
0xcert	ZXC
phi token	PHI
blocktix	TIX
hacken	HKN
aware	AT
4new	KWATT
maecenas	ART
alqo	XLQ
veriumreserve	VRM
exclusivecoin	EXCL
energo	TSL
trittium	TRTT
block array	ARY
stronghands	SHND
deex	DEEX
yocoin	YOC
credit tag chain	CTC
fox trading	FOXT
trustnote	TTT
esdchain	SDA
owndata	OWN
stox	STX
syndicate	SYNX
playgame	PXG
canyacoin	CAN
tigereum	TIG
0xbitcoin	0xBTC
sentinel chain	SENC
truegame	TGAME
iethereum	IETH
truedeck	TDP
nubits	USNBT
pinkcoin	PINK
vit	VIT
1world	1WO
lrm coin	LRM
datawallet	DXT
iqeon	IQN
mocrow	MCW
invacio	INV
pura	PURA
crowd machine	CMCT
tradove b2bcoin	BBC
thrive token	THRT
debitum	DEB
hicoin	XHI
bounty0x	BNTY
xpa	XPA
zilla	ZLA
qwark	QWARK
shield	XSH
procurrency	PROC
narrative	NRVE
wetrust	TRST
dopecoin	DOPE
uquid coin	UQC
experty	EXY
autonio	NIO
intercrone	ICR
oduwa	OWC
merculet	MVP
faceter	FACE
alphacat	ACAT
ethersocial	ESN
ixt	IXT
42-coin	42
realtract	RET
playkey	PKT
coinfi	COFI
mallcoin	MLC
arbidex	ABX
dether	DTH
2give	2GIVE
clearpoll	POLL
moneynet	MNC
intervalue	INVE
foldingcoin	FLDC
hold	HOLD
ip exchange	IPSX
gobyte	GBX
bethereum	BETHER
patron	PAT
arbitrage	ARB
idex membership	IDXM
bee token	BEE
bitcoin plus	XBC
blockmesh	BMH
flip	FLP
next.exchange	NEXT
snovian.space	SNOV
blacer coin	BLCR
fedoracoin	TIPS
optitoken	OPTI
goldmint	MNTP
bela	BELA
sprouts	SPRTS
ubcoin market	UBC
the champcoin	TCC
nexium	NXC
maverick chain	MVC
matryx	MTX
centauri	CTX
conceal	CCX
betterbetting	BETR
hbz coin	HBZ
dprating	RATING
airwire	WIRE
neoscoin	NEOS
wollo	WLO
heartbout	HB
zcore	ZCR
karbo	KRB
lightpaycoin	LPC
atonomi	ATMI
starbase	STAR
aphelion	APH
equal	EQL
utrum	OOT
aichain	AIT
fire lotto	FLOT
cannabiscoin	CANN
jet8	J8T
seal network	SEAL
zero	ZER
energycoin	ENRG
ryo currency	RYO
white standard	WSD
graviocoin	GIO
zippie	ZIPT
platoncoin	PLTC
eventchain	EVC
shard	SHARD
adshares	ADS
beat	BEAT
verime	VME
noir	NOR
mywish	WISH
freyrchain	FREC
stronghold usd	USDS
bettex coin	BTXC
uchain	UCN
flypme	FYP
veros	VRS
metamorph	METM
atbcoin	ATB
bitnautic token	BTNT
auctus	AUC
gravitycoin	GXX
social send	SEND
heronode	HER
coinlancer	CL
herocoin	PLAY
vulcano	VULC
fsbt api token	FSBT
relex	RLX
indorse token	IND
swisscoin	SIC
wabnetwork	WAB
apollon	XAP
coin lion	LION
auxilium	AUX
xovbank	XOV
eboost	EBST
zetacoin	ZET
biblepay	BBP
cryptocarbon	CCRB
proton token	PTT
arionum	ARO
elcoin	EL
sp8de	SPX
euno	EUNO
pigeoncoin	PGN
syncfab	MFG
adhive	ADH
monkey project	MONK
bitzeny	ZNY
siacashcoin	SCC
pareto rewards	PARETO
nper	NPER
quantis network	QUAN
buzzcoin	BUZZ
blockpass	PASS
bodhi eth	BOE
tena	TENA
bitether	BTR
block-logic	BLTG
aencoin	AEN
dash green	DASHG
devery	EVE
cryptoping	PING
bigbom	BBO
origin sport	ORS
lala world	LALA
equitrader	EQT
araw	ARAW
nerva	XNV
ionchain	IONC
signals network	SGN
pylon network	PYLNT
dogecash	DOGEC
ailink token	ALI
ethergem	EGEM
sumokoin	SUMO
blitzpredict	XBP
realchain	RCT
cryptonite	XCN
jetcoin	JET
naviaddress	NAVI
electrumdark	ELD
kalkulus	KLKS
mao zedong	MAO
bitdepositary	BDT
amon	AMN
xmct	XMCT
erc20	ERC20
exmr	EXMR
peng	PENG
hurify	HUR
evos	EVOS
temco	TEMCO
aditus	ADI
actinium	ACM
bob's repair	BOB
kolion	KLN
hyperquant	HQT
iungo	ING
alt.estate token	ALT
bonpay	BON
sharpay	S
bitcoin zero	BZX
paymon	PMNT
micromoney	AMM
boutspro	BOUTS
tokenbox	TBX
atomic coin	ATOM
quadrantprotocol	EQUAD
chronologic	DAY
tracto	TRCT
menlo one	ONE
bitrent	RNTB
knekted	KNT
wavesgo	WGO
webchain	WEB
zinc	ZINC
parkgene	GENE
teloscoin	TELOS
webcoin	WEB
sportyco	SPF
ether-1	ETHO
typerium	TYPE
bitwhite	BTW
more coin	MORE
uplexa	UPX
ace tokenstars	ACE
suretly	SUR
snodecoin	SND
iconiq lab token	ICNQ
aigang	AIX
tidex token	TDX
worldcore	WRC
cfun	CFUN
skincoin	SKIN
bitrewards	BIT
logiscoin	LGS
elysian	ELY
azart	AZART
eltcoin	ELTCOIN
eunomia	ENTS
peepcoin	PCN
spectrum	SPT
datarius credit	DTRC
draftcoin	DFT
transcodium	TNS
lobstex	LOBS
elixir	ELIX
modultrade	MTRC
netkoin	NTK
exosis	EXO
payfair	PFR
no bs crypto	NOBS
futurax	FTXT
absolute	ABS
idealcash	DEAL
evimeria	EVI
eurocointoken	ECTE
leadcoin	LDC
showhand	HAND
proxynode	PRX
blocklancer	LNC
puregold token	PGT
cryptoflow	CFL
thore cash	TCH
etherinc	ETI
unify	UNIFY
zeusnetwork	ZEUS
bitcoinus	BITS
ethereumx	ETX
mox	MOX
engagement token	ENGT
skyhub coin	SHB
pkg token	PKG
bitnation	XPAT
gohelpfund	HELP
emphy	EPY
paws fund	PAWS
neural protocol	NRP
mediccoin	MEDIC
scriv network	SCRIV
witchain	WIT
e-chat	ECHT
micromines	MICRO
soniq	SONIQ
catocoin	CATO
mmocoin	MMO
herbalist token	HERB
italian lira	ITL
tokendesk	TDS
viuly	VIU
gold poker	GPKR
arepacoin	AREPA
ndex	NDX
igtoken	IG
octoin coin	OCC
kz cash	KZC
apr coin	APR
plancoin	PLAN
empowr coin	EMPR
kwhcoin	KWH
briacoin	BRIA
roulettetoken	RLT
bunnytoken	BUNNY
primestone	PSC
banana token	BNANA
deltachain	DELTA
bitcoinote	BTCN
hashbx	HBX
sonder	SNR
provoco token	VOCO
posscoin	POSS
travelnote	TVNT
crystal token	CYL
cointogo	2GO
cybermusic	CYMT
quinads	QUIN
dowcoin	DOW
tourist token	TOTO
olympic	OLMP
bionic	BNC
bitball	BTB
cryptosoul	SOUL
havy	HAVY
vikkytoken	VIKKY
icobay	IBT
yolocash	YLC
roiyal coin	ROCO
desire	DSR
eaglex	EGX
thingschain	TIC
joint ventures	JOINT
mirai	MRI
cryptrust	CTRT
bitmoney	BIT
abulaba	AAA
nectar	NEC
centrality	CENNZ
iconomi	ICN
xceltoken	XCEL
lykke	LKK
bitnewchain	BTN
amo coin	AMO
dew	DEW
ecobit	ECOB
aeon	AEON
grid+	GRID
rubycoin	RBY
faircoin	FAIR
firstblood	1ST
amlt	AMLT
tronclassic	TRXC
dimecoin	DIME
diamond	DMD
nullex	NLX
pandacoin	PND
tv-two	TTV
starta	STA
taas	TAAS
ivy	IVY
proxeus	XES
mooncoin	MOON
ecc	ECC
mintcoin	MINT
bitdice	CSNO
xriba	XRA
shipchain	SHIP
gambit	GAM
kind ads token	KIND
dao.casino	BET
soarcoin	SOAR
foodcoin	FOOD
vites	VITES
wearesatoshi	WSX
cryptopay	CPAY
quark	QRK
chips	CHIPS
mysterium	MYST
alax	ALX
molecule	MOL
susd	SUSD
open platform	OPEN
hubii network	HBT
ethbits	ETBS
tokes	TKS
golos	GOLOS
blocktrade token	BTT
newyorkcoin	NYC
solaris	XLR
databits	DTB
likecoin	LIKE
leverj	LEV
new power coin	NPW
energitoken	ETK
encrypgen	DNA
bitdegree	BDG
petrodollar	XPD
b3coin	KB3
brahmaos	BRM
cdx network	CDX
ties.db	TIE
elite	1337
heat	HEAT
lomocoin	LMC
nushares	NSR
luna stars	LSTR
sether	SETH
fidentiax	FDX
rebl	REBL
eristica	ERT
auroracoin	AUR
maxcoin	MAX
vetri	VLD
savedroid	SVD
xenon	XNN
x8x token	X8X
globalboost-y	BSTY
pesetacoin	PTC
obits	OBITS
breakout stake	BRX
atmos	ATMOS
hellogold	HGT
bridge protocol	TOLL
terracoin	TRC
rentberry	BERRY
fidelium	FID
breakout	BRK
manna	MANNA
worldcoin	WDC
shivom	OMX
motocoin	MOTO
real	REAL
monster byte	MBI
lampix	PIX
smileycoin	SMLY
niobium coin	NBC
etheera	ETA
ethorse	HORSE
coinvest	COIN
sequence	SEQ
helium	HLM
w3coin	W3C
bitswift	BITS
talao	TALAO
orbitcoin	ORB
knoxstertoken	FKX
trezarcoin	TZC
verify	CRED
goodomy	GOOD
zeitcoin	ZEIT
evergreencoin	EGC
prasm	PSM
spectiv	SIG
mnpcoin	MNP
huntercoin	HUC
golfcoin	GOLF
jsecoin	JSE
croat	CROAT
force	FOR
hush	HUSH
ebitcoin	EBTC
kekcoin	KEK
litedoge	LDOGE
bitmark	BTM
daneel	DAN
photon	PHO
bitcoin scrypt	BTCS
reftoken	REF
carboncoin	CARBON
voise	VOISE
wandx	WAND
target coin	TGT
eztoken	EZT
magnet	MAG
sociall	SCL
bitibu coin	BTB
mindexcoin	MIC
rookiecoin	RKC
stipend	SPD
somee.social	ONG
niobio cash	NBR
bitclave	CAT
opus	OPT
e-gulden	EFL
popularcoin	POP
sharex	SEXC
shping	SHPING
condensate	RAIN
simmitri	SIM
sparkspay	SPK
adelphoi	ADL
soma	SCT
biocoin	BIO
startercoin	STAC
trollcoin	TROLL
ab-chain rtb	RTB
clearcoin	XCLR
crycash	CRC
audiocoin	ADC
hyperstake	HYP
imbrex	REX
bitbar	BTB
sapien	SPN
fantasygold	FGC
dinastycoin	DCY
cruisebit	CRBT
travelflex	TRF
iticoin	ITI
adcoin	ACC
cyclean	CCL
pwr coin	PWR
neutron	NTRN
commercium	CMM
supercoin	SUPER
view	VIEW
bunnycoin	BUN
gcn coin	GCN
nyancoin	NYAN
piggycoin	PIGGY
atmchain	ATM
denarius	D
vsync	VSX
posw coin	POSW
bitsilver	BITSILVER
obsidian	ODN
argentum	ARG
dcorp utility	DRPU
shekel	JEW
teslacoin	TES
simdaq	SMQ
ethersportz	ESZ
fabric token	FT
canada ecoin	CDN
lanacoin	LANA
bitcoen	BEN
bitcoin token	BTK
bitjob	STU
zennies	ZENI
mithril ore	MORE
blockcat	CAT
megacoin	MEC
monoeci	XMCC
trakinvest	TRAK
shadow token	SHDW
well	WELL
aquariuscoin	ARCO
straks	STAK
allsafe	SAFE
bitradio	BRO
op coin	OPC
ultranote coin	XUN
paycoin	XPY
digitalprice	DP
akroma	AKA
bitcloud	BTDX
cdmcoin	CDM
rupee	RUP
locicoin	LOCI
deutsche emark	DEM
spreadcoin	SPR
huzu	HUZU
biteur	BITEUR
bitbtc	BITBTC
model-x-coin	MODX
bitqy	BQ
bitgold	BITGOLD
magi	XMG
universe	UNI
elementrem	ELE
galactrum	ORE
piplcoin	PIPL
bluecoin	BLU
cryptosolartech	CST
ethereum meta	ETHM
opal	OPAL
joulecoin	XJO
level up coin	LUC
dragonglass	DGS
creditbit	CRB
tagcoin	TAG
ixcoin	IXC
trumpcoin	TRUMP
moin	MOIN
swing	SWING
ellaism	ELLA
emerald crypto	EMD
pakcoin	PAK
chesscoin	CHESS
startcoin	START
biotron	BTRN
blocknode	BND
campuscoin	CC
sharechain	SSS
tittiecoin	TIT
beacon	BECN
bbscoin	BBS
vivid coin	VIVID
sixeleven	611
btctalkcoin	TALK
adzcoin	ADZ
platinumbar	XPTX
ethereum cash	ECASH
hodlcoin	HODL
ignition	IC
xgox	XGOX
netko	NETKO
helleniccoin	HNC
bitstar	BITS
bata	BTA
gravity	GZRO
version	V
womencoin	WOMEN
inflationcoin	IFLT
forkcoin	FORK
globaltoken	GLT
cyberfm	CYFM
fundrequest	FND
castle	CSTL
crowdwiz	WIZ
kanadecoin	KNDC
cazcoin	CAZ
surety	SURE
putincoin	PUT
fujicoin	FJC
aced	ACED
bulleon	BUL
bitdeal	BDL
linx	LINX
sugar exchange	SGR
sakecoin	SAKE
rupaya	RUPX
wispr	WSP
crave	CRAVE
bloc.money	BLOC
orbis token	OBT
xdna	XDNA
genesisx	XGS
aegeus	AEG
oceanlab	OCL
opcoinx	OPCX
rimbit	RBT
sola token	SOL
origami	ORI
btc lite	BTCL
pitiscoin	PTS
digiwage	WAGE
ratecoin	XRA
compound coin	COMP
innova	INN
rubies	RBIES
bitsum	BSM
firstcoin	FRST
digitalcoin	DGC
iridium	IRD
synergy	SNRG
bitblocks	BBK
nitro	NOX
litecoin plus	LCP
dorado	DOR
tokia	TKA
masternet	MASH
arbitragect	ARCT
martexcoin	MXT
block-chain.com	BC
ico openledger	ICOO
jesus coin	JC
impleum	IMPL
phonecoin	PHON
bitcoin red	BTCRED
tekcoin	TEK
kurrent	KURT
jin coin	JIN
vslice	VSL
dach coin	DACHX
darextravel	DART
investfeed	IFT
insanecoin	INSN
goldblocks	GB
vivo	VIVO
regalcoin	REC
bolenum	BLN
nerves	NER
mcap	MCAP
bitcoin 21	XBTC21
blakecoin	BLC
atheios	ATH
crowdholding	YUP
yenten	YTN
master swiscoin	MSCN
cream	CRM
bolivarcoin	BOLI
votecoin	VOT
steepcoin	STEEP
skeincoin	SKC
mincoin	MNC
bitcoin2network	B2N
tokyo	TOKC
dietbitcoin	DDX
smartcoin	SMC
coin2.1	C2
gossipcoin	GOSS
authorship	ATS
kobocoin	KOBO
onix	ONX
minereum	MNE
ccore	CCO
arion	ARION
secretcoin	SCRT
berncash	BERN
8bit	8BIT
garlicoin	GRLC
qurito	QURO
pyrexcoin	PYX
privcy	PRIV
impact	IMX
evil coin	EVIL
earth token	EARTH
blast	BLAST
titcoin	TIT
mojocoin	MOJO
sono	SONO
joincoin	J
connectjob	CJT
carebit	CARE
britcoin	BRIT
crystal clear	CCT
cashcoin	CASH
project coin	PRJ
waletoken	WTN
fivebalance	FBN
tajcoin	TAJ
pure	PUREX
eurocoin	EUC
irishcoin	IRL
bank coin	BANK
pluracoin	PLURA
ethereum gold	ETG
bitstation	BSTN
adultchain	XXX
signatum	SIGT
zealium	NZL
purevidz	VIDZ
808coin	808
dystem	DTEM
cheesecoin	CHEESE
escroco emerald	ESCE
zozocoin	ZZC
guccionecoin	GCC
thunderstake	TSC
dreamcoin	DRM
citadel	CTL
neverdie	NDC
bitcoin adult	BTAD
ethbet	EBET
zurcoin	ZUR
centurion	CNT
rpicoin	RPI
theresa may coin	MAY
x-coin	XCO
dinero	DIN
peerguess	GUESS
kingn coin	KNC
elysium	ELS
folmcoin	FLM
ultracoin	UTC
high voltage	HVCO
grimcoin	GRIM
quebecoin	QBC
amsterdamcoin	AMS
shivers	SHVR
boat	BOAT
zoomba	ZBA
litecred	LTCR
eternity	ENT
graphcoin	GRPH
qyno	QNO
cryptojacks	CJ
bitspace	BSX
geysercoin	GSR
ezoow	EZW
securecoin	SRC
italo	XTA
parkbyte	PKB
indinode	XIND
ibtc	IBTC
boostcoin	BOST
nevacoin	NEVA
honey	HONEY
bitcoin one	BTCONE
zayedcoin	ZYD
safe trade coin	XSTC
datacoin	DTC
parallelcoin	DUO
brother	BRAT
greenmed	GRMD
nekonium	NUKO
nyerium	NYEX
qbic	QBIC
iq.cash	IQ
bumbacoin	BUMBA
postcoin	POST
posex	PEX
speedcash	SCS
bzlcoin	BZL
etheriya	RIYA
californium	CF
acoin	ACOIN
steneum coin	STN
fintab	FNTB
comet	CMT
litecoin ultra	LTCU
printex	PRTX
phantomx	PNX
neuro	NRO
bigup	BIGUP
dollarcoin	DLC
xchange	XCG
socialcoin	SOCC
ibank	IBANK
ammo reloaded	AMMO
icobid	ICOB
fuzzballs	FUZZ
rocketcoin	ROCK
trident group	TRDT
javascript token	JS
ourcoin	OUR
renos	RNS
eryllium	ERY
kun	KUN
mustangcoin	MST
flik	FLIK
uralscoin	URALS
dalecoin	DALC
whalecoin	WHL
freicoin	FRC
c-bit	XCT
prime-xi	PXI
milocoin	MILO
iconic	ICON
levocoin	LEVO
bankcoin	B@
bitcoal	COAL
bowscoin	BSC
rhenium	XRH
songcoin	SONG
arbit	ARB
bitcoin x	BTX
veltor	VLT
bitcoin planet	BTPL
postoken	POS
concoin	CONX
cabbage	CAB
ragnarok	RAGNA
plncoin	PLNC
benjirolls	BENJI
asiadigicoin	ADCN
vectorai	VEC2
litebitcoin	LBTC
alpha coin	APC
wild beast block	WBB
cannation	CNNC
bitvolt	VOLT
virtacoin	VTA
fujinto	NTO
project-x	NANOX
luna coin	LUNA
coinonatx	XCXT
coimatic 2.0	CTIC2
coinonat	CXT
save and gain	SANDG
geertcoin	GEERT
allion	ALL
ponzicoin	PONZI
anarchistsprime	ACP
staker	STR
gamblecoin	GMCN
vaperscoin	VPRC
crevacoin	CREVA
coupecoin	COUPE
magnum	MGM
acre	ACRE
smartfox	FOX
benz	BENZ
mero	MERO
coimatic 3.0	CTIC3
jiyo old	JIYO
playercoin	PLACO
interzone	ITZ
poly ai	AI
argus	ARGUS
cjs	CJS
shade token	SHADE
peony	PNY
mfit coin	MFIT
harmonycoin	HMC
ck usd	CKUSD
ontology gas	ONG
zb	ZB
fetch	FET
tigercash	TCH
bitmax token	BTMX
ankr network	ANKR
v systems	VSYS
cosmos	ATOM
bumo	BU
qusd	QUSD
digifinextoken	DFT
aidos kuneen	ADK
huobi pool token	HPT
ela coin	ELAC
playcoin qrc20	PLY
coni	CONI
coinex token	CET
beekan	BKBT
usdcoin	USC
mir coin	MIR
baer chain	BRC
super bitcoin	SBTC
influence chain	INC
game stars	GST
educoin	EDU
vethor token	VTHO
onotoken	ONOT
shinechain	SHE
you coin	YOU
consentium	CSM
ofcoin	OF
mytoken	MT
karatgold coin	KBC
wintoken	WIN
molecular future	MOF
fairgame	FAIR
futurocoin	FTO
pibble	PIB
carat	CARAT
flowchain	FLC
observer	OBSR
know	KNOW
themis	GET
hdac	HDAC
meet.one	MEETONE
eternal token	XET
starchain	STC
atlas protocol	ATP
hitchain	HIT
unlimitedip	UIP
topchain	TOPC
wiki token	WIKI
t.os	TOSC
sparkle	SPRKL
ilcoin	ILC
bora	BORA
key	KEY
lightchain	LIGHT
ti-value	TV
foin	FOIN
youlive coin	UC
yuan chain coin	YCC
nos	NOS
dipnet	DPN
win.win	TWINS
exchange union	XUC
twinkle	TKT
insurchain	INSUR
palletone	PTN
tcoin	TCN
esports token	EST
show	SHOW
weth	WETH
livepeer	LPT
investdigital	IDT
superedge	ECT
coinmeet	MEET
ether zero	ETZ
bitup token	BUT
ipchain	IPC
agoras tokens	AGRS
united bitcoin	UBTC
promotion coin	PC
carblock	CAR
bitcoinx	BCX
rif token	RIF
boatpilot token	NAVY
celsius	CEL
dacc	DACC
cotrader	COT
volt	ACDC
visionx	VNX
experience token	EXT
icechain	ICHX
seer	SEER
almeela	KZE
dascoin	DASC
constant	CONST
ordocoin	RDC
fundtoken	FUNDZ
apot	APOT
veridocglobal	VDG
marginless	MRS
cryptaldash	CRD
1sg	1SG
maggie	MAG
aunite	AUNIT
wxcoins	WXC
carinet	CIT
read	READ
oceanchain	OC
pixie coin	PXC
aidus token	AID
zeon	ZEON
clubcoin	CLUB
engine	EGCC
jewel	JWL
msd	MSD
gsenetwork	GSE
dexter	DXR
cybereits	CRE
bitcoin god	GOD
lemochain	LEMO
dragon coins	DRG
chex	CHEX
comsa eth	CMS
comsa xem	CMS
centercoin	CENT
wetoken	WT
usechain token	USE
mex	MEX
couchain	COU
mesg	MESG
m2o	M2O
qube	QUBE
otcbtc token	OTB
medibit	MEDIBIT
sdusd	SDUSD
ovcode	OVC
lunes	LUNES
wrapped bitcoin	WBTC
hercules	HERC
1x2 coin	1X2
vsportcoin	VSC
inmax	INX
webn token	WEBN
kingxchain	KXC
boltt coin	BOLTT
microbitcoin	MBC
jinbi token	JNB
diruna	DRA
sopay	SOP
messe token	MESSE
wizbl	WBL
infinitecoin	IFC
stockchain	SCC
robocalls	RC20
hxro	HXRO
dws	DWS
bitcoin file	BIFI
blockcdn	BCDN
xuez	XUEZ
jingtum tech	SWTC
agrolot	AGLT
gazecoin	GZE
litecointoken	LTK
stronghold token	SHX
verisafe	VSF
monero classic	XMC
cointorox	OROX
countinghouse	CHT
asura coin	ASA
bankera	BNK
bingo.fun	777
endorsit	EDS
candy	CANDY
eosblack	BLACK
darkpaycoin	DKPC
future1coin	F1C
safecoin	SAFE
carlive chain	IOV
cobrabytes	COBRA
hyper pay	HPY
nuggets	NUG
wi coin	WIC
haracoin	HRC
newstoken	NEWOS
gamblica	GMBC
sexcoin	SXC
ors group	ORS
terranova	TER
x12 coin	X12
mobilinktoken	MOLK
superior coin	SUP
rubex money	RBMC
fargocoin	FRGC
wincoin	WC
sigmacoin	SIGMA
hybrid block	HYB
ultra salescloud	UST
first bitcoin	BIT
civitas	CIV
coin2play	C2P
golos gold	GBG
nam coin	NAM
spectrumcash	XSM
president trump	PRES
shopzcoin	SZC
bingocoin	BOC
wys token	WYS
hero	HERO
traid	TRAID
capdaxtoken	XCD
bubble	BUB
escrowcoin	ESCO
gamechain system	GCS
xtrd	XTRD
savenode	SNO
segwit2x	B2X
era	ERA
ea coin	EAG
iquant	IQT
cardbuyers	BCARD
minex	MINEX
payday coin	PDX
yuki	YUKI
anon	ANON
valuto	VLU
cottoncoin	COTN
eplus coin	EPLUS
cmitcoin	CMIT
avatarcoin	AV
quotient	XQN
infinipay	IFP
plusonecoin	PLUS1
hondaiscoin	HNDC
budbo	BUBO
dynamiccoin	DMC
aces	ACES
dutch coin	DUTCH
elliot coin	ELLI
axiom	AXIOM
halloween coin	HALLO
runners	RUNNERS
proud money	PROUD
concierge coin	CCC
pandemia	PNDM
omencoin	OMEN
acchain	ACC
excaliburcoin	EXC
adenz	DNZ
giga	XG
storjcoin x	SJCX
snipcoin	SNIP
centaure	CEN
crowdvilla point	CROWD
betacoin	BET
rabbitcoin	RBBT
francs	FRN
tellurion	TELL
blazercoin	BLAZR
zengold	ZENGOLD
embercoin	EMB
birds	BIRDS
wink	WINK
bastonet	BSN
ethereum lite	ELITE
btcmoon	BTCM
bitbase	BTBc
valuechain	VLC
cropcoin	CROP
contractnet	CNET
salpay	SAL
fcoin token	FT
record	RCD
rocket pool	RPL
cedex coin	CEDEX
pecunio	PCO
obitan chain	OBTC
alttex	ALTX
rrcoin	RRC
abcc token	AT
allcoin	ALC
labh coin	LABH
emaratcoin	AEC
ztcoin	ZT
dragon token	DT
obxcoin	OBX
delizia	DELIZ
bgogo token	BGG
romtoken	ROM
tokok	TOK
albos	ALB
coz	COZ
idol coin	IDOL
xrt token	XRT
